古典音乐	古典音乐
当代时期古典	古典音乐
古典主义时期	古典音乐
浪漫主义时期	古典音乐
巴洛克时期	古典音乐
印象派作品	古典音乐
现代时期古典	古典音乐
雷击顿	雷鬼
雷鬼	雷鬼
舞池	雷鬼
斯卡	雷鬼
蓝调	蓝调
电声蓝调	蓝调
灵魂蓝调	蓝调
芝加哥蓝调	蓝调
爵士蓝调	蓝调
原声蓝调	蓝调
乡村蓝调	蓝调
三角洲蓝调	蓝调
摇滚	摇滚
流行摇滚	摇滚
朋克	摇滚
流行朋克	摇滚
独立摇滚	摇滚
轻摇滚	摇滚
日系摇滚	摇滚
另类摇滚	摇滚
金属	摇滚
新金属	摇滚
硬摇滚	摇滚
布鲁斯摇滚	摇滚
新浪潮	摇滚
梦幻流行	摇滚
迷幻摇滚	摇滚
英伦摇滚	摇滚
金属核	摇滚
前卫摇滚	摇滚
垃圾摇滚	摇滚
后摇	摇滚
死亡金属	摇滚
力量金属	摇滚
哥特金属	摇滚
工业摇滚	摇滚
工业金属	摇滚
华丽摇滚	摇滚
盯鞋	摇滚
后朋克	摇滚
黑金属	摇滚
鞭击金属	摇滚
速度金属	摇滚
华丽金属	摇滚
厄运金属	摇滚
民谣摇滚	摇滚
电子摇滚	摇滚
摇滚乐	摇滚
流行	流行
电子流行	流行
粤语流行	流行
抒情流行	流行
舞曲流行	流行
艺术流行	流行
独立流行	流行
成人当代	流行
拉丁流行	流行
日本流行	流行
韩国流行	流行
雷鬼流行	流行
爵士流行	流行
传统流行	流行
青年流行	流行
另类流行	流行
印度流行	流行
原声流行	流行
都市流行	流行
东南亚流行	流行
中东流行	流行
法国香颂	流行
迷幻流行	流行
欧洲流行	流行
室内乐流行	流行
蓝调流行	流行
民谣流行	流行
当代节奏布鲁斯	R&B
放克	R&B
灵魂乐	R&B
流行灵魂乐	R&B
新杰克摇摆	R&B
新灵魂乐	R&B
静谧风暴	R&B
深度灵魂乐	R&B
摩城音乐	R&B
经典灵魂乐	R&B
节奏布鲁斯	R&B
中国传统民族音乐	中国传统民族音乐
地方民歌	中国传统民族音乐
民歌	中国传统民族音乐
陕西民歌	中国传统民族音乐
江西民歌	中国传统民族音乐
民乐	中国传统民族音乐
传统民乐	中国传统民族音乐
中国艺术歌曲	中国传统民族音乐
北京小曲	中国传统民族音乐
曲艺	中国传统民族音乐
新民乐	中国传统民族音乐
云南民歌	中国传统民族音乐
湖南民歌	中国传统民族音乐
藏族民歌	中国传统民族音乐
山东民歌	中国传统民族音乐
台湾民歌	中国传统民族音乐
佤族民歌	中国传统民族音乐
朝鲜族民歌	中国传统民族音乐
西藏民歌	中国传统民族音乐
青海民歌	中国传统民族音乐
四川民歌	中国传统民族音乐
高山族民歌	中国传统民族音乐
江苏民歌	中国传统民族音乐
广东民歌	中国传统民族音乐
内蒙民歌	中国传统民族音乐
山西民歌	中国传统民族音乐
蒙古族民歌	中国传统民族音乐
维吾尔族民歌	中国传统民族音乐
新疆民歌	中国传统民族音乐
广西民歌	中国传统民族音乐
京剧	中国传统民族音乐
民族管弦乐	中国传统民族音乐
二人台	中国传统民族音乐
河南民歌	中国传统民族音乐
民族民歌	中国传统民族音乐
贵州民歌	中国传统民族音乐
东北民歌	中国传统民族音乐
土家族民歌	中国传统民族音乐
豫剧	中国传统民族音乐
花鼓戏	中国传统民族音乐
傣族民歌	中国传统民族音乐
民间小调	中国传统民族音乐
湖北民歌	中国传统民族音乐
苗族民歌	中国传统民族音乐
号子	中国传统民族音乐
彝族民歌	中国传统民族音乐
越剧	中国传统民族音乐
黄梅戏	中国传统民族音乐
秦腔	中国传统民族音乐
评弹	中国传统民族音乐
二人转	中国传统民族音乐
相声	中国传统民族音乐
浙江民歌	中国传统民族音乐
安徽民歌	中国传统民族音乐
山歌	中国传统民族音乐
粤剧	中国传统民族音乐
童谣	中国传统民族音乐
曲剧	中国传统民族音乐
上海民歌	中国传统民族音乐
河北民歌	中国传统民族音乐
羌族民歌	中国传统民族音乐
侗族民歌	中国传统民族音乐
评剧	中国传统民族音乐
海南民歌	中国传统民族音乐
河南坠子	中国传统民族音乐
鼓词	中国传统民族音乐
昆曲	中国传统民族音乐
壮族民歌	中国传统民族音乐
梆子戏	中国传统民族音乐
纳西族民歌	中国传统民族音乐
扬剧	中国传统民族音乐
重庆民歌	中国传统民族音乐
锡剧	中国传统民族音乐
婺剧	中国传统民族音乐
布依族民歌	中国传统民族音乐
风俗仪式歌	中国传统民族音乐
采茶戏	中国传统民族音乐
潮剧	中国传统民族音乐
天津时调	中国传统民族音乐
眉户剧	中国传统民族音乐
吕剧	中国传统民族音乐
数来宝	中国传统民族音乐
沪剧	中国传统民族音乐
甘肃民歌	中国传统民族音乐
歌仔戏	中国传统民族音乐
白族民歌	中国传统民族音乐
赣剧	中国传统民族音乐
福建民歌	中国传统民族音乐
楚剧	中国传统民族音乐
桂剧	中国传统民族音乐
秧歌戏	中国传统民族音乐
花灯戏	中国传统民族音乐
越调	中国传统民族音乐
评书	中国传统民族音乐
琼剧	中国传统民族音乐
碗碗腔	中国传统民族音乐
琴书	中国传统民族音乐
川剧	中国传统民族音乐
凤阳花鼓	中国传统民族音乐
淮剧	中国传统民族音乐
宁夏民歌	中国传统民族音乐
道情	中国传统民族音乐
山东快书	中国传统民族音乐
戏曲风	中国传统民族音乐
红歌	中国传统民族音乐
中国戏曲	中国传统民族音乐
哈萨克民歌	中国传统民族音乐
哈尼族民歌	中国传统民族音乐
电子舞曲	电子
国风电子	电子
民族电子	电子
浩室舞曲	电子
热带浩室	电子
电气浩室	电子
迪斯科	电子
科技舞曲	电子
芯片音乐	电子
独立电子	电子
前卫浩室	电子
英国车库舞曲	电子
未来贝斯	电子
回响重拍	电子
深浩室	电子
未来浩室	电子
鼓打贝斯	电子
缓拍	电子
后迪斯科	电子
出神舞曲	电子
氛围	电子
陷阱舞曲	电子
弛放	电子
硬派舞曲	电子
实验电子	电子
寒潮	电子
科技浩室	电子
放克浩室	电子
蒸汽波	电子
卡哇伊贝斯	电子
旋律回响重拍	电子
酸性浩室	电子
工业舞曲	电子
污派舞曲	电子
二步舞曲	电子
丛林音乐	电子
碎拍	电子
太空音乐	电子
电子音乐	电子
东方浩室	电子
嘻哈	嘻哈
流行说唱	嘻哈
另类说唱	嘻哈
旋律说唱	嘻哈
陷阱说唱	嘻哈
意识说唱	嘻哈
放克说唱	嘻哈
拉丁说唱	嘻哈
老派说唱	嘻哈
地下说唱	嘻哈
情绪说唱	嘻哈
匪帮说唱	嘻哈
西海岸说唱	嘻哈
南部说唱	嘻哈
法式说唱	嘻哈
欧洲说唱	嘻哈
硬核说唱	嘻哈
东海岸说唱	嘻哈
爵士说唱	嘻哈
云雾说唱	嘻哈
英伦说唱	嘻哈
日本说唱	嘻哈
实验说唱	嘻哈
脏说唱	嘻哈
自由说唱	嘻哈
中西部说唱	嘻哈
政治说唱	嘻哈
器乐说唱	嘻哈
情绪硬核	嘻哈
摇滚说唱	嘻哈
民谣	民谣
当代民谣	民谣
城市民谣	民谣
校园民谣	民谣
独立民谣	民谣
传统民谣	民谣
世界民谣	民谣
迷幻民谣	民谣
轻音乐	当代艺术音乐
当代艺术音乐	当代艺术音乐
器乐流行	当代艺术音乐
新世纪	当代艺术音乐
新古典新世纪	当代艺术音乐
太空新世纪	当代艺术音乐
氛围新世纪	当代艺术音乐
民族融合新世纪	当代艺术音乐
古典跨界	当代艺术音乐
日本新世纪	当代艺术音乐
沙发音乐	当代艺术音乐
凯尔特新世纪	当代艺术音乐
电子新世纪	当代艺术音乐
部落新世纪	当代艺术音乐
管弦乐流行	当代艺术音乐
自然新世纪	当代艺术音乐
艺术音乐	当代艺术音乐
先锋音乐	先锋音乐
中国通俗	中国通俗
大众流行风	中国通俗
网络流行风	中国通俗
DJ舞曲	中国通俗
中国风	中国通俗
古风	中国通俗
高原风	中国通俗
青春流行风	中国通俗
草原风	中国通俗
酒廊歌曲	中国通俗
当代民歌	中国通俗
时代颂歌	中国通俗
西域风	中国通俗
革命歌曲	中国通俗
军旅歌曲	中国通俗
喊麦	中国通俗
时代曲	中国通俗
台湾民歌运动	中国通俗
通俗音乐	中国通俗
爵士	爵士
波萨诺瓦	爵士
拉丁爵士	爵士
当代融合爵士	爵士
酸爵士	爵士
拉格泰姆	爵士
早期爵士	爵士
放克爵士	爵士
柔顺爵士	爵士
摇摆乐	爵士
大乐队&摇摆乐	爵士
融合爵士	爵士
交响爵士	爵士
波普乐	爵士
大乐队	爵士
人声爵士	爵士
新奥尔良爵士	爵士
世界爵士	爵士
芝加哥爵士	爵士
流行爵士	爵士
世界民族音乐	世界民族音乐
探戈	世界民族音乐
拉丁民族音乐	世界民族音乐
日韩朝民族音乐	世界民族音乐
日本民族音乐	世界民族音乐
欧洲民族音乐	世界民族音乐
韩国演歌	世界民族音乐
韩国民族音乐	世界民族音乐
中亚民族音乐	世界民族音乐
蒙古音乐	世界民族音乐
印度民族音乐	世界民族音乐
安第斯音乐	世界民族音乐
美洲传统音乐	世界民族音乐
印第安音乐	世界民族音乐
弗拉门戈	世界民族音乐
非洲民族音乐	世界民族音乐
波尔卡舞曲	世界民族音乐
凯尔特音乐	世界民族音乐
桑巴	世界民族音乐
东南亚民族音乐	世界民族音乐
印度尼西亚传统音乐	世界民族音乐
日本演歌	世界民族音乐
非洲打击乐	世界民族音乐
吉普赛音乐	世界民族音乐
中东民族音乐	世界民族音乐
古巴舞曲	世界民族音乐
巴西舞曲	世界民族音乐
阿拉伯传统音乐	世界民族音乐
泰国传统音乐	世界民族音乐
民族音乐	世界民族音乐
恰恰恰	世界民族音乐
拉丁	世界民族音乐
乡村	乡村
当代乡村	乡村
流行乡村	乡村
乡村摇滚	乡村
传统乡村	乡村
西部摇摆	乡村
乡村布吉	乡村
蓝草	乡村
另类乡村	乡村
牛仔	乡村
伊斯兰教音乐	宗教音乐
道教音乐	宗教音乐
梵呗	宗教音乐
佛教音乐	宗教音乐
藏传佛教音乐	宗教音乐
禅乐	宗教音乐
福音音乐	宗教音乐
基督教音乐	宗教音乐
宗教音乐	宗教音乐
当代佛教流行	宗教音乐
当代福音音乐	宗教音乐
